||||||||||||||||||||||||||||||
|__**************|***|*******|
|_||||||||||||||*|*|*|*|||||*|
|*|*|*******|*|**|*|*|*****|*|
|*|*|*|||||||*|************|*|
|*|*******|*|*****|*|*|****|*|
|*|||||||*|*|||*|*|*|*|**|*|*|
|*********|*****|***|**|*|*|*|
|||||||||||||*||||*|*|||*|*|||
|******|*|***|*****|*|*|*|***|
|*||||||*|||*|*|||||*|*|*|||*|
|******|***|*|*****|*****|***|
||*|*|||||*|*|||||||*|||||*|||
|**|*****|*|*********|***|***|
||*|||||*|*|||||||||||||*|||*|
|**|*****|*|***|***|*********|
|*||||||||*|*|||*|||*|||*|||||
|*|*|*|****|***|***|***|*****|
|*|*|*|||*||||||||*|*|*|||||*|
|***|***|**|*|*|***|*|*****|*|
|||||||*|**|*|*|*|*|*|||*|*|*|
|*|||||*|*||***********|||*|*|
|*******|*|****|***|***|***|*|
|||||||||*||||||*|*|*|*|*|||*|
|*****|**********|*|*|*|*|***|
|*|||||*||||||||||*|*|*|*|*|||
|********|*******|***|*|***|*|
|||*||**||||||||*|||||*|||||_|
|****************|*********__|
||||||||||||||||||||||||||||||